#########################################################
#                                                    @  #
#    ####################################################
#                                                       #
######################################################  #
#                                                       #
#    ####################################################
#                                                       #
######################################################  #
#                                                       #
#    ####################################################
#                                                       #
######################################################  #
#                                                       #
#    ####################################################
#                                                       =
#########################################################