#########################################################
#                 $  #      #     #         #  $  #  @  #
#              $     #   #  #  #  #         #     #     #
#           $        #   #  #  #  #         #           #
#        $           #   #  #  #  #$###$##$##     #     #
#     $                  #     #                  #     #
#   ###############################         #     #     #
#                                 #######################
################################                        #
#                                                       #
#    ####################################################
#                                                       #
#####$################################################  #
#                                                       #
#     ###################################################
#                                                       =
#########################################################